38*38 ressources/map/floor.png
6666666666666666666666666666666666666666666666666666666666666
6444433<<<<33<<<<763367<<<<33<<<<33<<<<63367<<<<33<<<<3344446
6444433<<<<33<<<<763367<<<<33<<<<33<<<<63367<<<<33<<<<3344446
6444433<<<<33<<<<763367<<<<33<<<<33<<<<63367<<<<33<<<<3344446
6<<<<==1111==1111=6336=1111==1111==<<<<6336=1111==1111==<<<<6
6<<<<<<<<<<<<<<<<<3333<<<<<<<<<<<<<<<<<3333<<<<<<<<<<<<<<<<<6
6<<<<<<<<<<<<<<<<<3333<<<<<<<<<<<<<<<<<3333<<<<<<<<<<<<<<<<<6
6<<<<<<<<<<<<<<<<<3333<<<<<<<<<<<<<<<<<3333<<<<<<<<<<<<<<<<<6
6<<<<==1111==1111=6336=1111==1111==<<<<6336=1111==1111==<<<<6
6444433<<<<33<<<<763367<<<<33<<<<33<<<<63367<<<<33<<<<3344446
6444433<<<<33<<<<763367<<<<33<<<<33<<<<63367<<<<33<<<<3344446
6444433<<<<33<<<<763367<<<<33<<<<33<<<<63367<<<<33<<<<3344446
6666666666666666666336666666666666666666336666666666666666666
6666666666666666666336666666666666666666336666666666666666666
6444433<<<<33<<<<763367<<<<33<<<<33<<<<63367<<<<33<<<<3344446
6444433<<<<33<<<<763367<<<<33<<<<33<<<<63367<<<<33<<<<3344446
6444433<<<<33<<<<763367<<<<33<<<<33<<<<63367<<<<33<<<<3344446
6<<<<==1111==1111=6336=1111==1111==11116336=1111==1111==<<<<6
6<<<<<<<<<<<<<<<<<3333<<<<<<<<<<<<<<<<<3333<<<<<<<<<<<<<<<<<6
6<<<<<<<<<<<<<<<<<3333<<<<<<<<<<<<<<<<<3333<<<<<<<<<<<<<<<<<6
6<<<<<<<<<<<<<<<<<3333<<<<<<<<<<<<<<<<<3333<<<<<<<<<<<<<<<<<6
6<<<<==1111==1111=6336=1111==1111==11116336=1111==1111==<<<<6
6444433<<<<33<<<<763367<<<<33<<<<33<<<<63367<<<<33<<<<3344446
6444433<<<<33<<<<763367<<<<33<<<<33<<<<63367<<<<33<<<<3344446
6444433<<<<33<<<<763367<<<<33<<<<33<<<<63367<<<<33<<<<3344446
6666666666666666666666666666666666666666666666666666666666666
