############
#         O#
#   P   ####
#          #
#######    #
#O   ##    #
#    ##    #
#          #
#       XX #
#       #  #
############
