****XXXXXXXXX**XXX
XX*****XXX*XXX****
X**XXX*XXX*X*XXXX*
**X****XX**XXX****
XXXXXX****XXXX*XXX
XXXXXXXXX*********
******XX***XXXXXX*
