TTGTTTTTTTTTTTTTTTTTTTTT
T0G0TTTTTTTTTTTTTTTTTTTT
TTGTTTTTTTTTTTTTTTTTTTTT
T0G0TTTTTTTTTTTTTTTTTTTT
TTGTTTTTTTTTTTTTTTTTTTTT
T0G0TTTTTTTTTTTTTTTTTTTT
TTGTTTTTTTTTTTTTTTTTTTTT
T0G0TTTTTTTTTTTTTTTTTTTT
TTGTTTTTTTTTTTTTTTTTTTTT
T0G0TTTTTTTTTTTTTTTTTTTT
TTGTTTTTTTTTTTTTTTTTTTTT
T0G0TTTTTTTTTTTTTTTTTTTT
TTGTTTTTTTTTTTTTTTTTTTTT
T0G0T0T0T0T0T0TTTHTTTTTT
TTGGGGGGGGGGGGGGGGTTTTTT
T0T0T0T0T0T0T0T0T0TTTTTT
TTTTTTTTTTTTTTTTTTTTTTTT
TTTTTTTTTTTTTTTTTTTTTTTT
